        Balrog

        Whip(active) = whips the target with a fire string wich cause devastating damage
        Fire(passive) = Has an aura of fire surronding it cause damage per second
        Fear(passive) = causes opponents withing an are unable to come closer(constand distance)
        Resistance(active)= Can resist all magic for a short period of time
        Ultimate Force(active)= Target dies if it comes to close too the ultimate are due to grip con
        
        Sauron
    
        Swing = Causes ha sword swing that will make + bonus damage + lifesteal
        Telekineses = Lift object(opponent) Causing stun/controll 
        Ring passive = Increases dmg, attack speed, as an aura to allies. + fire immune
        Inhuman passive = Critical strike - certain chance of critcal strike
        Ultimate(Call off the nine) = Summons one off the nine to assist him for various seconds

        Radagast

        Healing = Heals or resurrect
        SummonOftheforest = Summons wild animals that attacks
        Reshape/Hex = reshapes opponents to a random animal
        Eagle = summons eagle with x amount health that takes order from radagast
        Ultimate(resurrect) = brings back the dying to life

        Gandalf

        Light = Blinds the oppenent and affect it with fear
        Fire = Cast fire on opponent
        Compulsion = Taunt the enemy aswell as doing it weak
        Telekinesis = Move items (suprise attack)
        Ultimate(Flash) = Dealing damage to enemies within an certain area.

        Sauroman

        Uruk-hai = Spawn 2 urukhai to fight in his place
        Ensnare = Stuns enemies 
        Explosive = Cause an explosion that inflict damage to the opponent
        Boost = Give all allies around Saruman +attack, + speed + armor.
        Ultimate(Speech) = Takes control of the enemies to cast their own spells against them self)


